action,step,time,p,b,serving,c,getting
-,0,0.0,0,0,false,0,false
[producing],1,11.452049617693904,1,1,false,0,false
[con_ready],2,12.961770648127054,1,1,true,0,true
[consuming],3,15.862396312796445,1,0,false,1,false
[producing],4,98.62078425892436,2,1,false,1,false
[producing],5,107.0862300965599,3,2,false,1,false
[producing],6,111.6159235210361,4,3,false,1,false
[con_ready],7,117.63183961424772,4,3,true,1,true
[consuming],8,117.94023420973069,4,2,false,2,false
[producing],9,126.33527750682184,5,3,false,2,false
[producing],10,129.6635317638842,6,4,false,2,false
[producing],11,145.129045629057,7,5,false,2,false
[con_ready],12,155.82217029712646,7,5,true,2,true
[consuming],13,161.13471816110174,7,4,false,3,false
[con_ready],14,162.71137539005662,7,4,true,3,true
[consuming],15,162.72127904349475,7,3,false,4,false
[con_ready],16,166.79940348081823,7,3,true,4,true
[consuming],17,167.18457207426317,7,2,false,5,false
[producing],18,170.40315821458756,8,3,false,5,false
[con_ready],19,171.71510197927216,8,3,true,5,true
[consuming],20,172.6870214246014,8,2,false,6,false
[producing],21,175.710972665415,9,3,false,6,false
[con_ready],22,178.98048073430093,9,3,true,6,true
[consuming],23,179.46709165351763,9,2,false,7,false
[producing],24,189.80503837978856,10,3,false,7,false
[producing],25,200.92429634933862,11,4,false,7,false
[con_ready],26,203.58347439344186,11,4,true,7,true
[consuming],27,204.57219923294565,11,3,false,8,false
[producing],28,209.2033817450401,12,4,false,8,false
[producing],29,209.56075094372747,13,5,false,8,false
[con_ready],30,210.60692560558957,13,5,true,8,true
[consuming],31,211.1903784946137,13,4,false,9,false
[producing],32,225.96989893657553,14,5,false,9,false
[producing],33,232.31318418591343,15,6,false,9,false
[con_ready],34,232.65710764832446,15,6,true,9,true
[consuming],35,233.8210625559254,15,5,false,10,false
[con_ready],36,248.08702137754193,15,5,true,10,true
[consuming],37,248.44942931513737,15,4,false,11,false
[producing],38,260.0851518864019,16,5,false,11,false
[producing],39,261.40474133202457,17,6,false,11,false
[producing],40,299.8989256472528,18,7,false,11,false
[con_ready],41,301.32835492401506,18,7,true,11,true
[consuming],42,301.3437645611651,18,6,false,12,false
[con_ready],43,314.2165980333367,18,6,true,12,true
[consuming],44,314.22825661485706,18,5,false,13,false
[producing],45,315.62792115574206,19,6,false,13,false
[con_ready],46,346.283207616112,19,6,true,13,true
[consuming],47,347.20721299687756,19,5,false,14,false
[producing],48,352.5016108107716,20,6,false,14,false
[con_ready],49,368.90518387997446,20,6,true,14,true
[consuming],50,372.00528718534184,20,5,false,15,false
[con_ready],51,377.40259567362324,20,5,true,15,true
[consuming],52,377.4670713657401,20,4,false,16,false
[con_ready],53,386.1372927871137,20,4,true,16,true
[consuming],54,386.5237527494288,20,3,false,17,false
[con_ready],55,391.55785998672286,20,3,true,17,true
[consuming],56,392.8887285488859,20,2,false,18,false
[con_ready],57,393.9412018809136,20,2,true,18,true
[consuming],58,394.05799540545314,20,1,false,19,false
[producing],59,399.0546736609707,21,2,false,19,false
[producing],60,411.2141626332943,22,3,false,19,false
[producing],61,417.1053486965102,23,4,false,19,false
[producing],62,422.11051881241184,24,5,false,19,false
[producing],63,427.6658903871511,25,6,false,19,false
[con_ready],64,432.25964842661773,25,6,true,19,true
[consuming],65,432.3390312018991,25,5,false,20,false
[producing],66,446.00260963568337,26,6,false,20,false
[producing],67,459.94984370966273,27,7,false,20,false
[producing],68,460.2876972487899,28,8,false,20,false
[producing],69,463.3136785463296,29,9,false,20,false
[con_ready],70,466.62015827155955,29,9,true,20,true
[consuming],71,467.0331116189691,29,8,false,21,false
[producing],72,474.0514372716144,30,9,false,21,false
[producing],73,488.2454534024428,31,10,false,21,false
[producing],74,493.3065296815916,32,11,false,21,false
[producing],75,498.32928312351385,33,12,false,21,false
[producing],76,499.2869524775246,34,13,false,21,false
[producing],77,501.18051589283203,35,14,false,21,false
[con_ready],78,505.5997756311145,35,14,true,21,true
[consuming],79,507.0242510178174,35,13,false,22,false
[con_ready],80,526.9975067681628,35,13,true,22,true
[consuming],81,530.8995881149008,35,12,false,23,false
[producing],82,537.3377495360362,36,13,false,23,false
[producing],83,543.5278534689414,37,14,false,23,false
[producing],84,555.0080202206547,38,15,false,23,false
[con_ready],85,565.5639304578414,38,15,true,23,true
[consuming],86,566.7286983535278,38,14,false,24,false
[con_ready],87,572.7426961477646,38,14,true,24,true
[consuming],88,573.591244965955,38,13,false,25,false
[con_ready],89,575.6239056578763,38,13,true,25,true
[consuming],90,576.3665689572072,38,12,false,26,false
[producing],91,578.2131386646282,39,13,false,26,false
[producing],92,584.929417977857,40,14,false,26,false
[producing],93,609.7580667035138,41,15,false,26,false
[con_ready],94,610.4258888741706,41,15,true,26,true
[consuming],95,611.3949611895199,41,14,false,27,false
[producing],96,611.8659290469461,42,15,false,27,false
[con_ready],97,620.1552412349763,42,15,true,27,true
[consuming],98,620.2812502220867,42,14,false,28,false
[producing],99,626.3200683265275,43,15,false,28,false
[producing],100,627.1847447085277,44,16,false,28,false
[producing],101,631.3100345708687,45,17,false,28,false
[producing],102,636.0319724822115,46,18,false,28,false
[producing],103,643.1424018136627,47,19,false,28,false
[producing],104,653.9314058030045,48,20,false,28,false
[con_ready],105,656.324873787457,48,20,true,28,true
[consuming],106,656.5079330470008,48,19,false,29,false
[producing],107,656.9059148992998,49,20,false,29,false
[con_ready],108,656.9963519605186,49,20,true,29,true
[consuming],109,657.5483580993813,49,19,false,30,false
[producing],110,662.1481299070921,50,20,false,30,false
[producing],111,671.2270568770697,51,21,false,30,false
[con_ready],112,672.6873626762451,51,21,true,30,true
[consuming],113,673.6439998364671,51,20,false,31,false
[con_ready],114,678.6733410025262,51,20,true,31,true
[consuming],115,678.7990646101225,51,19,false,32,false
[producing],116,680.7333716555954,52,20,false,32,false
[con_ready],117,681.8004971364545,52,20,true,32,true
[consuming],118,682.4350426156816,52,19,false,33,false
[producing],119,689.4980979833724,53,20,false,33,false
[producing],120,694.9076341146437,54,21,false,33,false
[con_ready],121,694.9257589655957,54,21,true,33,true
[consuming],122,697.5030478204917,54,20,false,34,false
[con_ready],123,722.2534734644589,54,20,true,34,true
[consuming],124,722.5844467406563,54,19,false,35,false
[producing],125,734.3100100158746,55,20,false,35,false
[producing],126,743.548399118243,56,21,false,35,false
[con_ready],127,749.9270246270155,56,21,true,35,true
[consuming],128,752.0762285251867,56,20,false,36,false
[con_ready],129,755.5158897097851,56,20,true,36,true
[consuming],130,758.0707487004019,56,19,false,37,false
[con_ready],131,758.4984661835449,56,19,true,37,true
[consuming],132,758.5026731188563,56,18,false,38,false
[producing],133,771.7202972761181,57,19,false,38,false
[con_ready],134,782.8948183027201,57,19,true,38,true
[consuming],135,784.9242464554547,57,18,false,39,false
[producing],136,785.0695280657671,58,19,false,39,false
[con_ready],137,787.9867451404823,58,19,true,39,true
[consuming],138,788.7707694415294,58,18,false,40,false
[producing],139,789.1654909236339,59,19,false,40,false
[con_ready],140,793.0628720890464,59,19,true,40,true
[consuming],141,793.217299024033,59,18,false,41,false
[producing],142,794.5566121383989,60,19,false,41,false
[producing],143,797.8071061080559,61,20,false,41,false
[con_ready],144,815.1676817428475,61,20,true,41,true
[consuming],145,815.5064743030047,61,19,false,42,false
[con_ready],146,815.5640038216999,61,19,true,42,true
[consuming],147,815.832701937198,61,18,false,43,false
[con_ready],148,816.3303447511007,61,18,true,43,true
[consuming],149,816.6168635703826,61,17,false,44,false
[con_ready],150,839.130972938344,61,17,true,44,true
[consuming],151,839.578950238483,61,16,false,45,false
[producing],152,843.3277948105024,62,17,false,45,false
[producing],153,852.6767685794324,63,18,false,45,false
[producing],154,853.1073011299671,64,19,false,45,false
[con_ready],155,863.6664339289506,64,19,true,45,true
[consuming],156,864.0803101911058,64,18,false,46,false
[con_ready],157,873.9015107915998,64,18,true,46,true
[consuming],158,874.5967789460965,64,17,false,47,false
[producing],159,875.8398885186571,65,18,false,47,false
[producing],160,889.1591714190345,66,19,false,47,false
[producing],161,891.5044763874903,67,20,false,47,false
[con_ready],162,892.1912616798986,67,20,true,47,true
[consuming],163,892.5035391851045,67,19,false,48,false
[con_ready],164,898.107984750441,67,19,true,48,true
[consuming],165,899.5338840118462,67,18,false,49,false
[con_ready],166,903.5798581464486,67,18,true,49,true
[consuming],167,903.7265424505504,67,17,false,50,false
[producing],168,905.5822685758591,68,18,false,50,false
[producing],169,911.5109976279875,69,19,false,50,false
[producing],170,915.5692385869112,70,20,false,50,false
[con_ready],171,917.1184163656173,70,20,true,50,true
[consuming],172,918.8751663578084,70,19,false,51,false
[con_ready],173,922.7412242768894,70,19,true,51,true
[consuming],174,924.1683354773231,70,18,false,52,false
[con_ready],175,925.7176313701781,70,18,true,52,true
[consuming],176,926.6755419953778,70,17,false,53,false
[producing],177,938.4470712621043,71,18,false,53,false
[con_ready],178,939.989914666985,71,18,true,53,true
[consuming],179,940.8247245261654,71,17,false,54,false
[producing],180,946.268522442342,72,18,false,54,false
[producing],181,959.5015345812769,73,19,false,54,false
[con_ready],182,960.1130005983441,73,19,true,54,true
[consuming],183,961.9720143245548,73,18,false,55,false
[producing],184,966.1490714345422,74,19,false,55,false
[con_ready],185,967.2341874044401,74,19,true,55,true
[consuming],186,967.4807585059752,74,18,false,56,false
[producing],187,967.7588420505328,75,19,false,56,false
[producing],188,971.602955806853,76,20,false,56,false
[producing],189,974.7868927241004,77,21,false,56,false
[producing],190,979.7522055373016,78,22,false,56,false
[con_ready],191,984.3458193568749,78,22,true,56,true
[consuming],192,985.4642976573423,78,21,false,57,false
[producing],193,1004.040943876736,79,22,false,57,false
[con_ready],194,1015.0218975696569,79,22,true,57,true
[consuming],195,1016.2238259504733,79,21,false,58,false
[con_ready],196,1024.9257937922512,79,21,true,58,true
[consuming],197,1025.4819375783047,79,20,false,59,false
[producing],198,1034.5666422221266,80,21,false,59,false
[con_ready],199,1072.9394692834442,80,21,true,59,true
[consuming],200,1073.124006846081,80,20,false,60,false
[con_ready],201,1082.2922221415079,80,20,true,60,true
[consuming],202,1084.1045708227255,80,19,false,61,false
[con_ready],203,1085.0017778044996,80,19,true,61,true
[consuming],204,1085.7830887411035,80,18,false,62,false
[con_ready],205,1090.7448149289175,80,18,true,62,true
[consuming],206,1093.1968655546782,80,17,false,63,false
[con_ready],207,1134.198335009585,80,17,true,63,true
[consuming],208,1135.548687567914,80,16,false,64,false
[con_ready],209,1150.9552576303913,80,16,true,64,true
[consuming],210,1151.5219351836722,80,15,false,65,false
[con_ready],211,1159.590064157644,80,15,true,65,true
[consuming],212,1159.8114477721515,80,14,false,66,false
[con_ready],213,1160.4261171428923,80,14,true,66,true
[consuming],214,1163.1826768553085,80,13,false,67,false
[con_ready],215,1176.842602172342,80,13,true,67,true
[consuming],216,1178.5832467371404,80,12,false,68,false
[con_ready],217,1188.6948501820953,80,12,true,68,true
[consuming],218,1190.335517691351,80,11,false,69,false
[con_ready],219,1197.6010884786494,80,11,true,69,true
[consuming],220,1199.575962766632,80,10,false,70,false
[con_ready],221,1205.3308228565857,80,10,true,70,true
[consuming],222,1205.9521434254257,80,9,false,71,false
[con_ready],223,1207.6351510631428,80,9,true,71,true
[consuming],224,1209.918638672608,80,8,false,72,false
[con_ready],225,1225.538301828045,80,8,true,72,true
[consuming],226,1227.057682918258,80,7,false,73,false
[con_ready],227,1229.2013591226114,80,7,true,73,true
[consuming],228,1229.8903221476387,80,6,false,74,false
[con_ready],229,1230.583752801635,80,6,true,74,true
[consuming],230,1230.9958622301435,80,5,false,75,false
[con_ready],231,1234.666878797089,80,5,true,75,true
[consuming],232,1234.890873796949,80,4,false,76,false
[con_ready],233,1246.018814570459,80,4,true,76,true
[consuming],234,1248.6830862806266,80,3,false,77,false
[con_ready],235,1258.4454473175829,80,3,true,77,true
[consuming],236,1258.901422664419,80,2,false,78,false
[con_ready],237,1266.5184817749364,80,2,true,78,true
[consuming],238,1266.799927394327,80,1,false,79,false
[con_ready],239,1276.2422084318682,80,1,true,79,true
[consuming],240,1277.8779125565861,80,0,false,80,false
