action,step,time,p,b,serving,c,getting
-,0,0.0,0,0,false,0,false
[producing],1,8.766122399769422,1,1,false,0,false
[con_ready],2,50.09238348912437,1,1,true,0,true
[consuming],3,50.095409669170344,1,0,false,1,false
[producing],4,50.27705993793337,2,1,false,1,false
[con_ready],5,51.64347527695132,2,1,true,1,true
[consuming],6,51.773395170084804,2,0,false,2,false
[producing],7,56.6711328463872,3,1,false,2,false
[con_ready],8,63.81978717395173,3,1,true,2,true
[consuming],9,64.06774413106832,3,0,false,3,false
[producing],10,98.54537250994758,4,1,false,3,false
[producing],11,101.13142742743584,5,2,false,3,false
[con_ready],12,119.76707059836443,5,2,true,3,true
[consuming],13,120.51490701854718,5,1,false,4,false
[con_ready],14,132.41366459434232,5,1,true,4,true
[consuming],15,134.9394739837359,5,0,false,5,false
[producing],16,143.36502105861672,6,1,false,5,false
[producing],17,166.55433098690128,7,2,false,5,false
[producing],18,178.80244947170303,8,3,false,5,false
[con_ready],19,189.83126480864138,8,3,true,5,true
[consuming],20,190.60280114415193,8,2,false,6,false
[producing],21,190.68723472778734,9,3,false,6,false
[con_ready],22,201.92797413338275,9,3,true,6,true
[consuming],23,202.68183954449097,9,2,false,7,false
[producing],24,205.56434836595415,10,3,false,7,false
[producing],25,208.76323599010826,11,4,false,7,false
[con_ready],26,216.15009101070635,11,4,true,7,true
[consuming],27,216.8144614711005,11,3,false,8,false
[con_ready],28,234.0085984734668,11,3,true,8,true
[consuming],29,235.22176538063255,11,2,false,9,false
[con_ready],30,249.5963164367438,11,2,true,9,true
[consuming],31,249.87846698338598,11,1,false,10,false
[producing],32,257.0610404365397,12,2,false,10,false
[producing],33,281.73425737644317,13,3,false,10,false
[producing],34,286.5955303493331,14,4,false,10,false
[producing],35,288.16508352692523,15,5,false,10,false
[con_ready],36,296.78875579758494,15,5,true,10,true
[consuming],37,297.71513226220344,15,4,false,11,false
[producing],38,301.17598383104587,16,5,false,11,false
[con_ready],39,301.4703483692978,16,5,true,11,true
[consuming],40,302.2808438660556,16,4,false,12,false
[producing],41,309.7368662797817,17,5,false,12,false
[producing],42,321.59017492998,18,6,false,12,false
[con_ready],43,328.66164310040006,18,6,true,12,true
[consuming],44,330.705143284917,18,5,false,13,false
[producing],45,332.31901674299996,19,6,false,13,false
[con_ready],46,336.0857160768398,19,6,true,13,true
[consuming],47,336.3275805900921,19,5,false,14,false
[producing],48,337.61645273147775,20,6,false,14,false
[producing],49,344.48105810698115,21,7,false,14,false
[con_ready],50,344.5823105109222,21,7,true,14,true
[consuming],51,345.20234915192873,21,6,false,15,false
[producing],52,356.9324252328949,22,7,false,15,false
[con_ready],53,365.3994831501908,22,7,true,15,true
[consuming],54,366.46458472685254,22,6,false,16,false
[producing],55,371.8663113450569,23,7,false,16,false
[producing],56,375.3747674825187,24,8,false,16,false
[producing],57,385.29181124288226,25,9,false,16,false
[producing],58,385.9468884956654,26,10,false,16,false
[producing],59,386.2170135135167,27,11,false,16,false
[producing],60,391.0485199050003,28,12,false,16,false
[producing],61,410.86875532899506,29,13,false,16,false
[con_ready],62,417.3176078300863,29,13,true,16,true
[consuming],63,418.5759299105127,29,12,false,17,false
[producing],64,429.292708782328,30,13,false,17,false
[con_ready],65,436.9023173935282,30,13,true,17,true
[consuming],66,438.2893920975721,30,12,false,18,false
[con_ready],67,439.02704268587587,30,12,true,18,true
[consuming],68,439.4185771868627,30,11,false,19,false
[producing],69,441.31453163510605,31,12,false,19,false
[producing],70,444.2212307597939,32,13,false,19,false
[producing],71,447.0297119614538,33,14,false,19,false
[producing],72,463.21134691026583,34,15,false,19,false
[producing],73,474.4779307887568,35,16,false,19,false
[producing],74,484.8819902776591,36,17,false,19,false
[con_ready],75,491.34038017110356,36,17,true,19,true
[consuming],76,491.54614675378446,36,16,false,20,false
[producing],77,500.46442164465844,37,17,false,20,false
[producing],78,509.9246068110605,38,18,false,20,false
[producing],79,530.5692733659707,39,19,false,20,false
[con_ready],80,552.4598653592856,39,19,true,20,true
[consuming],81,554.0572031383805,39,18,false,21,false
[producing],82,557.4499839599625,40,19,false,21,false
[producing],83,567.3243620290629,41,20,false,21,false
[con_ready],84,568.3855647894899,41,20,true,21,true
[consuming],85,568.650748477553,41,19,false,22,false
[con_ready],86,578.5200654424197,41,19,true,22,true
[consuming],87,579.8213925132126,41,18,false,23,false
[con_ready],88,591.3783424143843,41,18,true,23,true
[consuming],89,592.2255350343393,41,17,false,24,false
[con_ready],90,605.6754422990173,41,17,true,24,true
[consuming],91,606.447305480734,41,16,false,25,false
[producing],92,607.9237696419505,42,17,false,25,false
[con_ready],93,611.514231777667,42,17,true,25,true
[consuming],94,612.0407422165073,42,16,false,26,false
[con_ready],95,625.8536932162506,42,16,true,26,true
[consuming],96,626.3355057593092,42,15,false,27,false
[con_ready],97,633.726398569909,42,15,true,27,true
[consuming],98,634.5495345664809,42,14,false,28,false
[producing],99,640.9507861209087,43,15,false,28,false
[producing],100,649.7518297125106,44,16,false,28,false
[con_ready],101,653.2887112522437,44,16,true,28,true
[consuming],102,655.9798892562093,44,15,false,29,false
[con_ready],103,656.482203432874,44,15,true,29,true
[consuming],104,657.9412468102627,44,14,false,30,false
[con_ready],105,674.0728217061502,44,14,true,30,true
[consuming],106,674.1206911736915,44,13,false,31,false
[producing],107,678.6637484921312,45,14,false,31,false
[producing],108,685.3969613897877,46,15,false,31,false
[con_ready],109,686.1600041140822,46,15,true,31,true
[consuming],110,687.743658634912,46,14,false,32,false
[producing],111,692.7547892100415,47,15,false,32,false
[con_ready],112,702.022342698421,47,15,true,32,true
[consuming],113,702.3648828235971,47,14,false,33,false
[con_ready],114,712.8716830889392,47,14,true,33,true
[consuming],115,712.9276585172646,47,13,false,34,false
[producing],116,730.5855632346725,48,14,false,34,false
[producing],117,731.4678860128564,49,15,false,34,false
[producing],118,737.0376438750469,50,16,false,34,false
[producing],119,742.2912560217896,51,17,false,34,false
[producing],120,743.2604015574415,52,18,false,34,false
[con_ready],121,745.8928050974752,52,18,true,34,true
[consuming],122,746.2125184437921,52,17,false,35,false
[producing],123,746.9307250423622,53,18,false,35,false
[producing],124,749.7195765720415,54,19,false,35,false
[con_ready],125,762.9868248300587,54,19,true,35,true
[consuming],126,764.2880299925139,54,18,false,36,false
[con_ready],127,765.9848780782031,54,18,true,36,true
[consuming],128,767.2083418099115,54,17,false,37,false
[con_ready],129,767.4245777103356,54,17,true,37,true
[consuming],130,769.978134545067,54,16,false,38,false
[con_ready],131,776.584402226138,54,16,true,38,true
[consuming],132,776.6671907105265,54,15,false,39,false
[producing],133,777.1146992123246,55,16,false,39,false
[con_ready],134,791.279867198481,55,16,true,39,true
[consuming],135,791.998781416936,55,15,false,40,false
[producing],136,799.9902323356482,56,16,false,40,false
[con_ready],137,802.2525349111683,56,16,true,40,true
[consuming],138,802.3180924894459,56,15,false,41,false
[con_ready],139,805.912005869541,56,15,true,41,true
[consuming],140,806.6887319347244,56,14,false,42,false
[producing],141,809.961419065338,57,15,false,42,false
[producing],142,823.0246542771761,58,16,false,42,false
[producing],143,829.1362601904258,59,17,false,42,false
[con_ready],144,835.5365266346702,59,17,true,42,true
[consuming],145,837.1189864869684,59,16,false,43,false
[producing],146,840.7198988241822,60,17,false,43,false
[con_ready],147,841.9466546218971,60,17,true,43,true
[consuming],148,842.3527401705842,60,16,false,44,false
[con_ready],149,843.5624212661967,60,16,true,44,true
[consuming],150,845.1298025382636,60,15,false,45,false
[con_ready],151,846.9171482435261,60,15,true,45,true
[consuming],152,850.8594294926901,60,14,false,46,false
[con_ready],153,861.3892954239703,60,14,true,46,true
[consuming],154,863.5464389537186,60,13,false,47,false
[con_ready],155,865.3118503545222,60,13,true,47,true
[consuming],156,865.4126219776879,60,12,false,48,false
[con_ready],157,873.3589845586143,60,12,true,48,true
[consuming],158,873.820317364377,60,11,false,49,false
[producing],159,880.3538165713697,61,12,false,49,false
[producing],160,884.7599445796287,62,13,false,49,false
[producing],161,887.7926353934522,63,14,false,49,false
[con_ready],162,897.7584561054595,63,14,true,49,true
[consuming],163,899.8805702582642,63,13,false,50,false
[producing],164,910.6321800979147,64,14,false,50,false
[con_ready],165,911.43071961624,64,14,true,50,true
[consuming],166,912.1161220601272,64,13,false,51,false
[con_ready],167,915.7916664041641,64,13,true,51,true
[consuming],168,917.0066663333745,64,12,false,52,false
[producing],169,917.4293561546965,65,13,false,52,false
[producing],170,917.5983453962939,66,14,false,52,false
[producing],171,917.9166671330648,67,15,false,52,false
[con_ready],172,925.7998265639887,67,15,true,52,true
[consuming],173,927.3850315972645,67,14,false,53,false
[producing],174,927.429695506521,68,15,false,53,false
[con_ready],175,927.6114230872289,68,15,true,53,true
[consuming],176,928.705271897583,68,14,false,54,false
[con_ready],177,929.2612330808614,68,14,true,54,true
[consuming],178,930.1853604352325,68,13,false,55,false
[con_ready],179,932.2008619690315,68,13,true,55,true
[consuming],180,932.637033267213,68,12,false,56,false
[producing],181,937.7707562853691,69,13,false,56,false
[producing],182,938.0518849582719,70,14,false,56,false
[producing],183,941.3967781337118,71,15,false,56,false
[producing],184,943.0637676338386,72,16,false,56,false
[producing],185,946.6821916300811,73,17,false,56,false
[producing],186,960.2017757824167,74,18,false,56,false
[con_ready],187,961.3276930725317,74,18,true,56,true
[consuming],188,962.0129069611498,74,17,false,57,false
[producing],189,969.6179850700119,75,18,false,57,false
[con_ready],190,970.9681106571821,75,18,true,57,true
[consuming],191,970.9866980385584,75,17,false,58,false
[con_ready],192,986.7226075654622,75,17,true,58,true
[consuming],193,987.4142731436738,75,16,false,59,false
[producing],194,987.885144055414,76,17,false,59,false
[con_ready],195,1006.5208522993504,76,17,true,59,true
[consuming],196,1006.5467855559825,76,16,false,60,false
[con_ready],197,1007.7651199336649,76,16,true,60,true
[consuming],198,1008.5137596232282,76,15,false,61,false
[producing],199,1010.7875582580609,77,16,false,61,false
[con_ready],200,1024.8666164062288,77,16,true,61,true
[consuming],201,1025.8894441717434,77,15,false,62,false
[producing],202,1036.667848727011,78,16,false,62,false
[producing],203,1054.2290896884188,79,17,false,62,false
[con_ready],204,1055.1990252189728,79,17,true,62,true
[consuming],205,1056.3983280566358,79,16,false,63,false
[producing],206,1058.2039828051509,80,17,false,63,false
[con_ready],207,1078.0785745215146,80,17,true,63,true
[consuming],208,1079.5457563461482,80,16,false,64,false
[con_ready],209,1090.4098977989684,80,16,true,64,true
[consuming],210,1091.6830298742923,80,15,false,65,false
[con_ready],211,1091.9869455277205,80,15,true,65,true
[consuming],212,1092.7016342047407,80,14,false,66,false
[con_ready],213,1094.7016889172053,80,14,true,66,true
[consuming],214,1096.6592587735277,80,13,false,67,false
[con_ready],215,1102.9642802427175,80,13,true,67,true
[consuming],216,1103.088329930612,80,12,false,68,false
[con_ready],217,1105.5096775287902,80,12,true,68,true
[consuming],218,1105.9714105492315,80,11,false,69,false
[con_ready],219,1108.724341921638,80,11,true,69,true
[consuming],220,1110.422289123026,80,10,false,70,false
[con_ready],221,1110.7487731410513,80,10,true,70,true
[consuming],222,1110.8671562488846,80,9,false,71,false
[con_ready],223,1118.2308023842993,80,9,true,71,true
[consuming],224,1119.248342456521,80,8,false,72,false
[con_ready],225,1125.364401813892,80,8,true,72,true
[consuming],226,1127.0083704629353,80,7,false,73,false
[con_ready],227,1138.1052542498692,80,7,true,73,true
[consuming],228,1139.6109001745724,80,6,false,74,false
[con_ready],229,1160.510112432741,80,6,true,74,true
[consuming],230,1160.656025115875,80,5,false,75,false
[con_ready],231,1174.3735046725712,80,5,true,75,true
[consuming],232,1176.6537223747246,80,4,false,76,false
[con_ready],233,1195.2495826620218,80,4,true,76,true
[consuming],234,1195.6349491021876,80,3,false,77,false
[con_ready],235,1198.4795281887057,80,3,true,77,true
[consuming],236,1199.4061693661965,80,2,false,78,false
[con_ready],237,1219.5965257620003,80,2,true,78,true
[consuming],238,1221.3165928416447,80,1,false,79,false
[con_ready],239,1224.9397329596472,80,1,true,79,true
[consuming],240,1225.9323148698911,80,0,false,80,false
