action,step,time,p,b,serving,c,getting
-,0,0.0,0,0,false,0,false
[producing],1,5.4444840259235985,1,1,false,0,false
[producing],2,8.067212941045124,2,2,false,0,false
[con_ready],3,11.205160672607409,2,2,true,0,true
[consuming],4,12.815413044126247,2,1,false,1,false
[con_ready],5,13.771022686270166,2,1,true,1,true
[consuming],6,14.472731295968469,2,0,false,2,false
[producing],7,46.30222981286488,3,1,false,2,false
[producing],8,50.566189144605346,4,2,false,2,false
[producing],9,56.20555943806908,5,3,false,2,false
[producing],10,62.95744361833236,6,4,false,2,false
[con_ready],11,65.05927369414779,6,4,true,2,true
[consuming],12,65.74328637832558,6,3,false,3,false
[producing],13,65.85820747591276,7,4,false,3,false
[producing],14,69.24686446300468,8,5,false,3,false
[producing],15,88.48782469605305,9,6,false,3,false
[producing],16,90.21534107773151,10,7,false,3,false
[con_ready],17,93.59331179277707,10,7,true,3,true
[consuming],18,95.44828859547218,10,6,false,4,false
[con_ready],19,110.7928397969888,10,6,true,4,true
[consuming],20,112.54204407657961,10,5,false,5,false
[con_ready],21,113.49824131721556,10,5,true,5,true
[consuming],22,116.39672226640401,10,4,false,6,false
[con_ready],23,120.62404527321904,10,4,true,6,true
[consuming],24,122.7600512253356,10,3,false,7,false
[producing],25,129.8205273258545,11,4,false,7,false
[producing],26,135.66003739845522,12,5,false,7,false
[con_ready],27,138.18278336800287,12,5,true,7,true
[consuming],28,138.64022584572024,12,4,false,8,false
[con_ready],29,139.63743589924724,12,4,true,8,true
[consuming],30,139.84757853118376,12,3,false,9,false
[producing],31,151.11685866310333,13,4,false,9,false
[producing],32,158.75412131328648,14,5,false,9,false
[con_ready],33,174.83606402659714,14,5,true,9,true
[consuming],34,174.83870293039968,14,4,false,10,false
[producing],35,176.09850209592602,15,5,false,10,false
[producing],36,180.52277485439535,16,6,false,10,false
[producing],37,184.84440646627766,17,7,false,10,false
[con_ready],38,192.73206441340926,17,7,true,10,true
[consuming],39,193.39437351355042,17,6,false,11,false
[con_ready],40,194.68733460726608,17,6,true,11,true
[consuming],41,194.98184140750786,17,5,false,12,false
[producing],42,203.76777722376005,18,6,false,12,false
[con_ready],43,206.66732660222573,18,6,true,12,true
[consuming],44,206.82722318157084,18,5,false,13,false
[con_ready],45,211.45072353921918,18,5,true,13,true
[consuming],46,212.54715041750907,18,4,false,14,false
[con_ready],47,223.65628574426512,18,4,true,14,true
[consuming],48,225.33922689047276,18,3,false,15,false
[producing],49,225.87079502608373,19,4,false,15,false
[producing],50,226.7867966828555,20,5,false,15,false
[producing],51,227.9276114318742,21,6,false,15,false
[producing],52,229.06499558126845,22,7,false,15,false
[con_ready],53,233.7204400648979,22,7,true,15,true
[consuming],54,234.28590572331717,22,6,false,16,false
[con_ready],55,237.31806083306628,22,6,true,16,true
[consuming],56,238.63653636555816,22,5,false,17,false
[producing],57,246.62462910803652,23,6,false,17,false
[con_ready],58,251.601951007522,23,6,true,17,true
[consuming],59,251.99212380042903,23,5,false,18,false
[con_ready],60,254.60008784380398,23,5,true,18,true
[consuming],61,254.936360657256,23,4,false,19,false
[con_ready],62,265.63874084908866,23,4,true,19,true
[consuming],63,266.81476582724724,23,3,false,20,false
[producing],64,270.02677911377043,24,4,false,20,false
[con_ready],65,289.90525305096213,24,4,true,20,true
[consuming],66,290.4622245680205,24,3,false,21,false
[con_ready],67,293.92868098945127,24,3,true,21,true
[consuming],68,296.6363317890526,24,2,false,22,false
[con_ready],69,302.9317444773766,24,2,true,22,true
[consuming],70,303.89391483832605,24,1,false,23,false
[con_ready],71,304.63586287529034,24,1,true,23,true
[consuming],72,306.87121855507314,24,0,false,24,false
[producing],73,316.3330333601317,25,1,false,24,false
[con_ready],74,319.5097723523726,25,1,true,24,true
[consuming],75,319.789064098771,25,0,false,25,false
[producing],76,325.3405958350368,26,1,false,25,false
[con_ready],77,342.633122544775,26,1,true,25,true
[consuming],78,343.66735959399136,26,0,false,26,false
[producing],79,424.9278383147252,27,1,false,26,false
[con_ready],80,431.97228172364044,27,1,true,26,true
[consuming],81,433.4699296532625,27,0,false,27,false
[producing],82,444.13744005172833,28,1,false,27,false
[producing],83,460.22325681067684,29,2,false,27,false
[con_ready],84,461.0698735120387,29,2,true,27,true
[consuming],85,461.26288588137425,29,1,false,28,false
[producing],86,461.2968759977598,30,2,false,28,false
[producing],87,462.991925851148,31,3,false,28,false
[producing],88,466.4187773381621,32,4,false,28,false
[con_ready],89,471.04696109720607,32,4,true,28,true
[consuming],90,471.24018089176633,32,3,false,29,false
[producing],91,473.6479149227792,33,4,false,29,false
[con_ready],92,473.93043048457815,33,4,true,29,true
[consuming],93,473.9641881930216,33,3,false,30,false
[con_ready],94,474.3765356268873,33,3,true,30,true
[consuming],95,475.1095967805154,33,2,false,31,false
[producing],96,482.4401897939802,34,3,false,31,false
[con_ready],97,486.68670052127845,34,3,true,31,true
[consuming],98,487.0487870218585,34,2,false,32,false
[con_ready],99,487.9245361570723,34,2,true,32,true
[consuming],100,488.4884434475168,34,1,false,33,false
[con_ready],101,488.9171122770763,34,1,true,33,true
[consuming],102,488.99305675233796,34,0,false,34,false
[producing],103,511.3571947476358,35,1,false,34,false
[producing],104,518.1626621180158,36,2,false,34,false
[producing],105,520.6335806103592,37,3,false,34,false
[producing],106,526.4407286787365,38,4,false,34,false
[producing],107,528.1244885844231,39,5,false,34,false
[producing],108,534.1669291415656,40,6,false,34,false
[producing],109,535.0740674801132,41,7,false,34,false
[con_ready],110,559.5786608263428,41,7,true,34,true
[consuming],111,560.5332353040219,41,6,false,35,false
[producing],112,571.0598732100757,42,7,false,35,false
[producing],113,574.8810212820484,43,8,false,35,false
[producing],114,602.014632742105,44,9,false,35,false
[con_ready],115,609.2660704114207,44,9,true,35,true
[consuming],116,609.5007920468779,44,8,false,36,false
[producing],117,615.5419686741992,45,9,false,36,false
[con_ready],118,616.5206475249034,45,9,true,36,true
[consuming],119,619.5277033011272,45,8,false,37,false
[producing],120,631.6624179545256,46,9,false,37,false
[con_ready],121,632.5956527346278,46,9,true,37,true
[consuming],122,633.1750441287417,46,8,false,38,false
[con_ready],123,636.0667158025858,46,8,true,38,true
[consuming],124,637.41632682431,46,7,false,39,false
[con_ready],125,644.9796864681199,46,7,true,39,true
[consuming],126,645.1267244728066,46,6,false,40,false
[producing],127,657.8672065799858,47,7,false,40,false
[producing],128,664.1353523839069,48,8,false,40,false
[con_ready],129,669.9475637177578,48,8,true,40,true
[consuming],130,671.2049004780121,48,7,false,41,false
[con_ready],131,675.0612132111985,48,7,true,41,true
[consuming],132,675.5059265464729,48,6,false,42,false
[producing],133,678.400016532751,49,7,false,42,false
[producing],134,683.4737795699298,50,8,false,42,false
[con_ready],135,688.5292965880004,50,8,true,42,true
[consuming],136,689.098613912899,50,7,false,43,false
[con_ready],137,697.7775415869291,50,7,true,43,true
[consuming],138,697.7895621984263,50,6,false,44,false
[con_ready],139,700.3093195240176,50,6,true,44,true
[consuming],140,700.5242129283127,50,5,false,45,false
[producing],141,704.8491919457764,51,6,false,45,false
[con_ready],142,705.4579067219784,51,6,true,45,true
[consuming],143,705.644372849427,51,5,false,46,false
[producing],144,708.14961548907,52,6,false,46,false
[con_ready],145,719.4655601719886,52,6,true,46,true
[consuming],146,719.6728196499549,52,5,false,47,false
[con_ready],147,722.5538978466178,52,5,true,47,true
[consuming],148,722.631535144776,52,4,false,48,false
[producing],149,731.8822387815014,53,5,false,48,false
[con_ready],150,737.381957863335,53,5,true,48,true
[consuming],151,737.8688380629487,53,4,false,49,false
[producing],152,747.3020130770351,54,5,false,49,false
[con_ready],153,752.2567071656161,54,5,true,49,true
[consuming],154,752.5754214671227,54,4,false,50,false
[producing],155,759.3083011871712,55,5,false,50,false
[con_ready],156,765.8767301706922,55,5,true,50,true
[consuming],157,766.4714715162619,55,4,false,51,false
[producing],158,771.8615131937383,56,5,false,51,false
[con_ready],159,772.3168319306811,56,5,true,51,true
[consuming],160,773.6945376774158,56,4,false,52,false
[con_ready],161,777.2833492458632,56,4,true,52,true
[consuming],162,778.0016626341303,56,3,false,53,false
[producing],163,778.8375496383453,57,4,false,53,false
[con_ready],164,788.0282212414024,57,4,true,53,true
[consuming],165,788.5899208862733,57,3,false,54,false
[con_ready],166,789.3726932034657,57,3,true,54,true
[consuming],167,790.0050683440548,57,2,false,55,false
[con_ready],168,799.7324175286294,57,2,true,55,true
[consuming],169,801.9480831741226,57,1,false,56,false
[producing],170,805.4171117968367,58,2,false,56,false
[con_ready],171,819.9021701255512,58,2,true,56,true
[consuming],172,821.202707572015,58,1,false,57,false
[producing],173,829.802655570216,59,2,false,57,false
[producing],174,831.0738242422334,60,3,false,57,false
[con_ready],175,836.4240662720854,60,3,true,57,true
[consuming],176,838.561840160417,60,2,false,58,false
[producing],177,839.25911042301,61,3,false,58,false
[con_ready],178,840.5994631367892,61,3,true,58,true
[consuming],179,841.3027754728272,61,2,false,59,false
[producing],180,844.1386763198567,62,3,false,59,false
[con_ready],181,846.3352573859421,62,3,true,59,true
[consuming],182,846.5352381013822,62,2,false,60,false
[con_ready],183,854.0289922380302,62,2,true,60,true
[consuming],184,855.236695796103,62,1,false,61,false
[con_ready],185,856.6913922990767,62,1,true,61,true
[consuming],186,857.3424590049383,62,0,false,62,false
[producing],187,858.1389971871081,63,1,false,62,false
[con_ready],188,866.3949569740752,63,1,true,62,true
[consuming],189,867.6025466234693,63,0,false,63,false
[producing],190,870.792737728875,64,1,false,63,false
[producing],191,870.8657771487259,65,2,false,63,false
[producing],192,871.9526795241468,66,3,false,63,false
[producing],193,872.1517378249459,67,4,false,63,false
[producing],194,873.5191917697132,68,5,false,63,false
[con_ready],195,874.6237595696035,68,5,true,63,true
[consuming],196,875.0464107152073,68,4,false,64,false
[con_ready],197,886.5582888106434,68,4,true,64,true
[consuming],198,887.0167190445496,68,3,false,65,false
[con_ready],199,911.3214806390722,68,3,true,65,true
[consuming],200,913.0999238039321,68,2,false,66,false
[producing],201,919.2676291940838,69,3,false,66,false
[producing],202,920.1522594112622,70,4,false,66,false
[producing],203,920.6994820076007,71,5,false,66,false
[producing],204,922.9302927702931,72,6,false,66,false
[producing],205,923.0661666915897,73,7,false,66,false
[con_ready],206,928.6559558209013,73,7,true,66,true
[consuming],207,928.7184832242791,73,6,false,67,false
[producing],208,929.447759528578,74,7,false,67,false
[con_ready],209,936.9428779978584,74,7,true,67,true
[consuming],210,939.2307981527899,74,6,false,68,false
[con_ready],211,966.6201330711197,74,6,true,68,true
[consuming],212,967.4468823884727,74,5,false,69,false
[con_ready],213,967.6825443501341,74,5,true,69,true
[consuming],214,969.6270331715665,74,4,false,70,false
[producing],215,985.8949477638891,75,5,false,70,false
[producing],216,987.2461746014906,76,6,false,70,false
[producing],217,993.7225254033888,77,7,false,70,false
[producing],218,996.8118637687105,78,8,false,70,false
[producing],219,1012.0407313742294,79,9,false,70,false
[con_ready],220,1013.262787688839,79,9,true,70,true
[consuming],221,1013.4579250069205,79,8,false,71,false
[con_ready],222,1015.4295325888369,79,8,true,71,true
[consuming],223,1016.478893258084,79,7,false,72,false
[producing],224,1016.5787980334987,80,8,false,72,false
[con_ready],225,1018.370471386663,80,8,true,72,true
[consuming],226,1020.5595249740103,80,7,false,73,false
[con_ready],227,1026.9806694344338,80,7,true,73,true
[consuming],228,1027.8343881567803,80,6,false,74,false
[con_ready],229,1042.6964713210668,80,6,true,74,true
[consuming],230,1044.034451144193,80,5,false,75,false
[con_ready],231,1063.8186098817898,80,5,true,75,true
[consuming],232,1064.159566032119,80,4,false,76,false
[con_ready],233,1078.6787648790373,80,4,true,76,true
[consuming],234,1079.1122338046782,80,3,false,77,false
[con_ready],235,1095.6603213291714,80,3,true,77,true
[consuming],236,1096.9055975818405,80,2,false,78,false
[con_ready],237,1128.893540902807,80,2,true,78,true
[consuming],238,1128.8975004009546,80,1,false,79,false
[con_ready],239,1137.0306773665388,80,1,true,79,true
[consuming],240,1137.3615696715472,80,0,false,80,false
