action,step,time,p,b,serving,c,getting
-,0,0.0,0,0,false,0,false
[producing],1,4.074633043592574,1,1,false,0,false
[producing],2,20.143789129889512,2,2,false,0,false
[con_ready],3,30.003257972783132,2,2,true,0,true
[consuming],4,30.746332653993612,2,1,false,1,false
[producing],5,32.17767088233775,3,2,false,1,false
[con_ready],6,43.60266440096469,3,2,true,1,true
[consuming],7,44.06168835753836,3,1,false,2,false
[con_ready],8,64.1578467049505,3,1,true,2,true
[consuming],9,64.88470032249764,3,0,false,3,false
[producing],10,101.21288049647148,4,1,false,3,false
[con_ready],11,107.08127277452243,4,1,true,3,true
[consuming],12,107.28170841632372,4,0,false,4,false
[producing],13,119.06850709738416,5,1,false,4,false
[con_ready],14,119.11672287032786,5,1,true,4,true
[consuming],15,120.87686616342917,5,0,false,5,false
[producing],16,130.8512978875237,6,1,false,5,false
[producing],17,137.10734467389173,7,2,false,5,false
[con_ready],18,144.18896478336322,7,2,true,5,true
[consuming],19,144.2916331287405,7,1,false,6,false
[con_ready],20,151.54941500749692,7,1,true,6,true
[consuming],21,151.92505583574626,7,0,false,7,false
[producing],22,154.32177353755026,8,1,false,7,false
[producing],23,181.63043905244677,9,2,false,7,false
[con_ready],24,187.71616312118394,9,2,true,7,true
[consuming],25,189.97905478250553,9,1,false,8,false
[con_ready],26,191.6006915733177,9,1,true,8,true
[consuming],27,192.41534503370076,9,0,false,9,false
[producing],28,236.31502252480502,10,1,false,9,false
[producing],29,241.69528037134444,11,2,false,9,false
[producing],30,246.06335825921144,12,3,false,9,false
[producing],31,246.85294128321596,13,4,false,9,false
[producing],32,258.1918030234131,14,5,false,9,false
[con_ready],33,263.8499418120412,14,5,true,9,true
[consuming],34,263.8840318096577,14,4,false,10,false
[producing],35,273.7906212848268,15,5,false,10,false
[con_ready],36,275.2565476095699,15,5,true,10,true
[consuming],37,276.58636418128884,15,4,false,11,false
[producing],38,287.7282197218767,16,5,false,11,false
[con_ready],39,292.13682815517274,16,5,true,11,true
[consuming],40,293.3115487739983,16,4,false,12,false
[con_ready],41,293.69807893601444,16,4,true,12,true
[consuming],42,294.81444630446407,16,3,false,13,false
[con_ready],43,303.33804022142635,16,3,true,13,true
[consuming],44,303.436763430176,16,2,false,14,false
[producing],45,309.85122830067047,17,3,false,14,false
[con_ready],46,310.73311557752845,17,3,true,14,true
[consuming],47,311.49429006879956,17,2,false,15,false
[con_ready],48,316.03531726930606,17,2,true,15,true
[consuming],49,316.9039651694116,17,1,false,16,false
[con_ready],50,318.05466214103035,17,1,true,16,true
[consuming],51,319.1117349635905,17,0,false,17,false
[producing],52,345.3621965501665,18,1,false,17,false
[con_ready],53,351.3995191339897,18,1,true,17,true
[consuming],54,351.58791413463257,18,0,false,18,false
[producing],55,384.3654739954748,19,1,false,18,false
[con_ready],56,401.29883274292246,19,1,true,18,true
[consuming],57,401.7208323442048,19,0,false,19,false
[producing],58,413.00395991132496,20,1,false,19,false
[producing],59,427.1667660498471,21,2,false,19,false
[producing],60,433.75428501768414,22,3,false,19,false
[con_ready],61,435.0743777719079,22,3,true,19,true
[consuming],62,436.22956861234894,22,2,false,20,false
[con_ready],63,438.5742654062323,22,2,true,20,true
[consuming],64,438.80871269316236,22,1,false,21,false
[con_ready],65,439.1165249057262,22,1,true,21,true
[consuming],66,439.38518599801813,22,0,false,22,false
[producing],67,440.3918706521282,23,1,false,22,false
[producing],68,452.0067417344621,24,2,false,22,false
[producing],69,455.7728648288013,25,3,false,22,false
[producing],70,457.09236781621536,26,4,false,22,false
[producing],71,458.53504844652497,27,5,false,22,false
[producing],72,466.7626169773648,28,6,false,22,false
[con_ready],73,477.5094290694705,28,6,true,22,true
[consuming],74,477.7861147349285,28,5,false,23,false
[producing],75,493.08085943900585,29,6,false,23,false
[con_ready],76,498.16802370485084,29,6,true,23,true
[consuming],77,498.4273397878638,29,5,false,24,false
[con_ready],78,499.46248535493396,29,5,true,24,true
[consuming],79,499.7644374099857,29,4,false,25,false
[producing],80,500.0862780919732,30,5,false,25,false
[con_ready],81,509.157662937079,30,5,true,25,true
[consuming],82,510.84497956555333,30,4,false,26,false
[producing],83,521.5758604572004,31,5,false,26,false
[con_ready],84,522.159099741346,31,5,true,26,true
[consuming],85,522.9402115119699,31,4,false,27,false
[con_ready],86,528.7540991752318,31,4,true,27,true
[consuming],87,530.2739752929762,31,3,false,28,false
[con_ready],88,535.1707107112857,31,3,true,28,true
[consuming],89,535.5946034219369,31,2,false,29,false
[con_ready],90,541.1638747762299,31,2,true,29,true
[consuming],91,541.8291962832508,31,1,false,30,false
[producing],92,542.7913674572362,32,2,false,30,false
[producing],93,545.2420179847196,33,3,false,30,false
[con_ready],94,549.9489088736636,33,3,true,30,true
[consuming],95,551.3226818649995,33,2,false,31,false
[con_ready],96,559.3199232275883,33,2,true,31,true
[consuming],97,560.1191400669919,33,1,false,32,false
[producing],98,575.6647746601346,34,2,false,32,false
[producing],99,576.7039713606287,35,3,false,32,false
[producing],100,577.9943416662218,36,4,false,32,false
[producing],101,579.9176355593042,37,5,false,32,false
[con_ready],102,581.9240885642246,37,5,true,32,true
[consuming],103,582.7360298496761,37,4,false,33,false
[con_ready],104,594.106606539361,37,4,true,33,true
[consuming],105,594.1840109426504,37,3,false,34,false
[producing],106,595.5047097786467,38,4,false,34,false
[con_ready],107,610.6215407635618,38,4,true,34,true
[consuming],108,611.380194601252,38,3,false,35,false
[producing],109,612.1865228430605,39,4,false,35,false
[con_ready],110,617.2965674844944,39,4,true,35,true
[consuming],111,618.0174281324117,39,3,false,36,false
[con_ready],112,619.5725348781687,39,3,true,36,true
[consuming],113,619.9395276059747,39,2,false,37,false
[producing],114,628.7766560257817,40,3,false,37,false
[producing],115,631.0467868698785,41,4,false,37,false
[con_ready],116,636.5825867019477,41,4,true,37,true
[consuming],117,638.7173092735472,41,3,false,38,false
[producing],118,639.6926675669953,42,4,false,38,false
[con_ready],119,640.0290277050964,42,4,true,38,true
[consuming],120,644.0167200767395,42,3,false,39,false
[producing],121,644.5758634747252,43,4,false,39,false
[con_ready],122,658.7274652446564,43,4,true,39,true
[consuming],123,659.38146125066,43,3,false,40,false
[producing],124,665.8013735553232,44,4,false,40,false
[producing],125,667.0585263106366,45,5,false,40,false
[con_ready],126,671.1095524382096,45,5,true,40,true
[consuming],127,673.0920703215147,45,4,false,41,false
[con_ready],128,681.0221731550585,45,4,true,41,true
[consuming],129,681.1774006941255,45,3,false,42,false
[con_ready],130,682.3341800023561,45,3,true,42,true
[consuming],131,684.2177596896448,45,2,false,43,false
[con_ready],132,694.008199053955,45,2,true,43,true
[consuming],133,694.8962078691587,45,1,false,44,false
[con_ready],134,695.2135981942589,45,1,true,44,true
[consuming],135,695.5593550326873,45,0,false,45,false
[producing],136,706.0150498038419,46,1,false,45,false
[con_ready],137,712.6324888294912,46,1,true,45,true
[consuming],138,712.7104899234522,46,0,false,46,false
[producing],139,718.3129342301702,47,1,false,46,false
[con_ready],140,724.8394205586355,47,1,true,46,true
[consuming],141,724.8522024258109,47,0,false,47,false
[producing],142,726.6299481777183,48,1,false,47,false
[producing],143,726.821354635035,49,2,false,47,false
[con_ready],144,735.2497241968678,49,2,true,47,true
[consuming],145,736.0257192037276,49,1,false,48,false
[con_ready],146,747.0063322137555,49,1,true,48,true
[consuming],147,747.8560539770232,49,0,false,49,false
[producing],148,753.9510776186628,50,1,false,49,false
[producing],149,763.3681183818398,51,2,false,49,false
[con_ready],150,765.3739074024248,51,2,true,49,true
[consuming],151,767.0572468115129,51,1,false,50,false
[producing],152,779.3153423213485,52,2,false,50,false
[con_ready],153,783.5717388567876,52,2,true,50,true
[consuming],154,783.8708699580184,52,1,false,51,false
[producing],155,784.4646583781857,53,2,false,51,false
[producing],156,789.18218031069,54,3,false,51,false
[producing],157,813.1210718801931,55,4,false,51,false
[con_ready],158,813.625150606672,55,4,true,51,true
[consuming],159,814.4351135884477,55,3,false,52,false
[con_ready],160,818.910155541994,55,3,true,52,true
[consuming],161,819.0191304164287,55,2,false,53,false
[producing],162,820.4176426187724,56,3,false,53,false
[producing],163,828.1790470690783,57,4,false,53,false
[producing],164,832.3832326654629,58,5,false,53,false
[producing],165,840.3082610714249,59,6,false,53,false
[con_ready],166,845.1440110244373,59,6,true,53,true
[consuming],167,846.1856036373028,59,5,false,54,false
[con_ready],168,848.4361077864568,59,5,true,54,true
[consuming],169,849.70478584415,59,4,false,55,false
[con_ready],170,851.6263344775625,59,4,true,55,true
[consuming],171,851.6518299187702,59,3,false,56,false
[con_ready],172,856.7593156952541,59,3,true,56,true
[consuming],173,857.3265929297548,59,2,false,57,false
[con_ready],174,867.4330996683664,59,2,true,57,true
[consuming],175,868.1397107671245,59,1,false,58,false
[producing],176,894.8925318759706,60,2,false,58,false
[producing],177,894.9349346168347,61,3,false,58,false
[con_ready],178,895.3991854719247,61,3,true,58,true
[consuming],179,896.4681827322087,61,2,false,59,false
[con_ready],180,904.4075229297858,61,2,true,59,true
[consuming],181,904.5450619073912,61,1,false,60,false
[producing],182,906.7104167393993,62,2,false,60,false
[con_ready],183,921.0512861827154,62,2,true,60,true
[consuming],184,922.1779825107876,62,1,false,61,false
[producing],185,934.8388496520515,63,2,false,61,false
[producing],186,946.729925067446,64,3,false,61,false
[con_ready],187,956.770409504792,64,3,true,61,true
[consuming],188,957.1493885948522,64,2,false,62,false
[producing],189,961.7541114316955,65,3,false,62,false
[con_ready],190,970.6416788618697,65,3,true,62,true
[consuming],191,971.5194771579663,65,2,false,63,false
[producing],192,982.1638120403366,66,3,false,63,false
[con_ready],193,983.7687109068407,66,3,true,63,true
[consuming],194,984.6783261636454,66,2,false,64,false
[producing],195,1000.6317842672696,67,3,false,64,false
[con_ready],196,1010.2654298314562,67,3,true,64,true
[consuming],197,1011.013462551817,67,2,false,65,false
[con_ready],198,1013.5852284505058,67,2,true,65,true
[consuming],199,1015.4714842651972,67,1,false,66,false
[producing],200,1016.5068906479826,68,2,false,66,false
[producing],201,1019.2927932470183,69,3,false,66,false
[con_ready],202,1032.0637029318807,69,3,true,66,true
[consuming],203,1033.006613166331,69,2,false,67,false
[producing],204,1034.4829899512235,70,3,false,67,false
[producing],205,1036.8052728631053,71,4,false,67,false
[con_ready],206,1041.7739513686856,71,4,true,67,true
[consuming],207,1044.790268965888,71,3,false,68,false
[producing],208,1046.3624472711128,72,4,false,68,false
[producing],209,1047.8423073640943,73,5,false,68,false
[producing],210,1080.6099092977975,74,6,false,68,false
[producing],211,1083.4718985945333,75,7,false,68,false
[producing],212,1090.628803637373,76,8,false,68,false
[con_ready],213,1094.737934436556,76,8,true,68,true
[consuming],214,1094.8257423603682,76,7,false,69,false
[con_ready],215,1095.504774501544,76,7,true,69,true
[consuming],216,1097.8751857879615,76,6,false,70,false
[con_ready],217,1105.0732718681197,76,6,true,70,true
[consuming],218,1105.2607297031516,76,5,false,71,false
[con_ready],219,1106.486165671246,76,5,true,71,true
[consuming],220,1107.311461830882,76,4,false,72,false
[con_ready],221,1107.7037512917486,76,4,true,72,true
[consuming],222,1108.0601604117546,76,3,false,73,false
[producing],223,1108.5420499911288,77,4,false,73,false
[con_ready],224,1109.1285621653974,77,4,true,73,true
[consuming],225,1110.777875757888,77,3,false,74,false
[con_ready],226,1123.665132528667,77,3,true,74,true
[consuming],227,1126.46099777653,77,2,false,75,false
[producing],228,1137.9613470772335,78,3,false,75,false
[con_ready],229,1140.1713845233182,78,3,true,75,true
[consuming],230,1142.3562149984018,78,2,false,76,false
[producing],231,1148.1597760583068,79,3,false,76,false
[con_ready],232,1151.1674309925322,79,3,true,76,true
[consuming],233,1152.3585997834518,79,2,false,77,false
[producing],234,1153.3837995029526,80,3,false,77,false
[con_ready],235,1158.65062673002,80,3,true,77,true
[consuming],236,1159.0983265985362,80,2,false,78,false
[con_ready],237,1167.8987631090938,80,2,true,78,true
[consuming],238,1169.4322943080215,80,1,false,79,false
[con_ready],239,1170.2192090633666,80,1,true,79,true
[consuming],240,1170.6111788905164,80,0,false,80,false
